arab: Arabic alphabet

armenian: Armenian alphabet

avestan: Avestan alphabet

balinese: Balinese alphabet

bamum: Bamum alphabet

bashkir: Bashkir alphabet

bassa-vah: Bassa-vah alphabet

batak: Batak alphabet

belarusian: Belarusian alphabet

bengali: Bengali alphabet

bopomofo: Bopomofo alphabet. Zhuyin

brahmi: Brahmi alphabet

buginese: Buginese alphabet

buhid: Buhid alphabet

bulgarian: Bulgarian alphabet

carian: Carian alphabet

caucasian-albanian: Caucasian albanian alphabet

chakma: Chakma alphabet

cham: Cham alphabet

cherokee: Cherokee alphabet

chinese: Chinese pinyin alphabet

coptic: Coptic alphabet

cypriot-syllabary: Cypriot syllabary

cyrillic: Cyrillic alphabet

czech: Czech alphabet

deseret: Deseret alphabet

devanagari: Devanagari alphabet

elbasan: Elbasan alphabet

english: English alphabet

esperanto: Esperanto alphabet

ethiopic: Ethiopic Ge ªez alphabet

french: French alphabet

georgian: Georgian alphabet

german: German alphabet

glagolitic: Glagolitic alphabet

gothic: Gothic alphabet

grantha: Grantha alphabet

greek: Greek alphabet

gujarati: Gujarati alphabet

gurmukhi: Gurmukhi alphabet

hangul: Hangul alphabet

hanunoo: Hanunoo alphabet

hebrew: Hebrew alphabet

hungarian: Hungarian alphabet

imperial-aramaic: Imperial aramaic alphabet

international-phonetic-alphabet: International phonetic alphabet

italian: Italian alphabet

japanese-hiragana: Japanese hiragana alphabet

japanese-katakana: Japanese katakana alphabet

javanese: Javanese alphabet

kaithi: Kaithi alphabet

kannada: Kannada alphabet

kayah-li: Kayah li alphabet

kazakh: Kazakh alphabet

kharoshthi: Kharoshthi alphabet

khmer: Khmer alphabet

khojki: Khojki alphabet

khudawadi: Khudawadi alphabet

lao: Lao alphabet

latin: Latin alphabet

lepcha: Lepcha alphabet

limbu: Limbu alphabet

linear-b-Syllabary: Linear B syllabary

lisu: Lisu alphabet

lycian: Lycian alphabet

lydian: Lydian alphabet

nabataean: Nabataean alphabet

mahajani: Mahajani alphabet

malayalam: Malayalam alphabet

mandaic: Mandaic alphabet

manichaean: Manichaean alphabet

meetei-mayek: Meetei mayek alphabet

mende-kikakui: Mende kikakui alphabet

meroitic-cursive: Meroitic cursive alphabet

modi: Modi alphabet

mongolian: Mongolian alphabet

mro: Mro alphabet

myanmar: Myanmar alphabet

new-tai-lue: New tai lue alphabet

nko: Nko alphabet

ogham: Ngham alphabet

ol-chiki: Ol chiki alphabet

old-italic: Old italic etruscan alphabet

old-north-arabian: Old north arabian alphabet

old-permic: Old permic alphabet

old-persian: Old persian alphabet

old-south-arabian: Old south arabian alphabet

old-turkic: Old turkic runic alphabet

oriya: Oriya alphabet

osmanya: Osmanya alphabet

pahawh-hmong: Pahawh hmong alphabet

pahlavi: Pahlavi alphabet

palmyrene: Palmyrene alphabet

pau-cin-hau: Pau cin hau alphabet

phags-pa: Phags-pa alphabet

phoenician: Phoenician alphabet

polish: Polish alphabet

pollard: Pollard alphabet

rejang: Rejang alphabet

runic: Runic alphabet

russian: Russian alphabet

samaritan: Samaritan alphabet

saurashtra: Saurashtra alphabet

sharada: Sharada alphabet

shavian: Shavian alphabet

siddham: Siddham alphabet

sinhala: Sinhala alphabet

sora-sompeng: Sora sompeng alphabet

spanish: Spanish alphabet

sundanese: Sundanese alphabet

syloti-nagri: Syloti nagri alphabet

syriac: Syriac alphabet

tagalog: Tagalog alphabet

tagbanwa: Tagbanwa alphabet

tai-le: Tai le alphabet

tai-tham: Tai tham alphabet

tai-viet: Tai viet alphabet

takri: Takri alphabet

tamil: Tamil alphabet

tatar: Tatar alphabet

telugu: Telugu alphabet

thaana: Thaana alphabet

thai: Thai alphabet

tibetan: Tibetan alphabet

tifinagh: Tifinagh alphabet

tirhuta: Tirhuta alphabet

turkish: Turkish alphabet

ugaritic: Ugaritic alphabet

ukrainian: Ukrainian alphabet

unified-canadian-aboriginal-syllabics: Unified canadian aboriginal syllabary

vai: Vai syllabary

varang-kshiti: Varang kshiti alphabet

yi-syllables: Yi syllabary