abkhazian       : 阿布哈西亚语
ainu            : 艾努语
arabic          : 阿拉伯语
armenian        : 亚美尼亚语
amharic         : 阿姆哈拉语
balinese        : 巴厘语
bamum           : 巴姆穆语
batak           : 巴塔克语
bengali         : 孟加拉语
buhid           : 布锡语
buginese        : 布吉语
bulgarian       : 保加利亚语
burmese         : 缅甸语
celtic          : 凯尔特语
cham            : 占语
cherokee        : 切罗基语
chinese         : 汉语
cia-cia         : 吉阿吉阿语
coptic          : 科普特语
cree            : 克里语
croatian        : 克罗地亚语
dravidian       : 达罗毗荼语系
ethiopian-semitic : 埃塞俄比亚闪米特语族
english         : 英语
french          : 法语
georgian        : 格鲁吉亚语
german          : 德语
greek           : 希腊语
hanunoo         : 哈鲁喏语
hebrew          : 希伯来语
hindi           : 印地语
italian         : 意大利语
indian          : 印度语
japanese        : 日语
javanese        : 爪哇语
kayah           : 克耶语
khmer           : 高棉语
komi            : 科米语
korean          : 韩语
kurd            : 库尔德语
laotian         : 老挝语
lepcha          : 雷布查语
limbu           : 林布语
lisu            : 傈僳语
makassarese     : Makassarese
maldivian       : 迪维希语
maltese         : 马耳他语
mandaic         : Mandaic
mandar          : Mandar
marathi         : 马拉地语
mongolian       : 蒙古语
nko             : Nko语
okinawan        : 冲绳语
old-church-slavic : 古教堂斯拉夫语
old-italic      : 老意大利语
oriya           : 奥里亚语
palauan         : 帕劳语
palaun          : Palaun
pali            : 巴利语
polish          : 波兰语
punjabi         : 旁遮普语
persian         : 波斯语
pictish         : 皮克特语
primitive-irish : 原始爱尔兰语
rejang          : 勒姜语
runic           : 卢恩字母
russian         : 俄语
sanskrit        : 梵语
santali         : 桑塔利语
sami            : 萨米语
sasak           : Sasak
saurashtra      : 索拉什特拉语
sinhalese       : 僧伽罗语
slovenian       : 斯洛文尼亚语
sundanese       : 巽他语
sylheti         : Sylheti
syrian          : 叙利亚语
tagalog         : 他加禄语
tamil           : 泰米尔语
telugu          : 泰卢固语
thai            : 泰语
tibetan         : 藏语
tigtinya        : 提格里尼亚语
tuareg          : 图阿雷格语
turkish         : 土耳其语
ukrainian       : 乌克兰语
uyghur          : 维吾尔语
vai             : 瓦伊语
vietnamese      : 越南语
yi              : 彝语
yiddish         : 意第绪语
